
 ┌───────────┐
 │...I.......│
 │...........│
 ├─────+──+──┤
 │...........│
 │...........│
 │...........│
 └───────────┘
