###############
#┌───────────┐#
#│...........│#
#│..I........│#
#│...........│#
#├─────+──+──┤#
#│...........│#
#│...........│#
#│...........│#
#└───────────┘#
###############
